3.2 3.2
2.0 2.0
0.0
4 4 4 4 4 4 4
4 0 0 0 0 0 4
4 0 0 0 2 0 4
4 1 1 0 2 0 4
4 0 0 0 2 0 4
4 0 0 2 0 0 4
4 4 3 4 4 4 4
